######
#  .##
# $  #
#.   #
# $$.#
#    #
# .$@#
#    #
######
