  #####
###   #
#@$$  #
# . .##
#   #
#####