###########
##       ##
##   $ .  #
#         #
#.  $   $ #
#  .$ .   #
#    ..$$ #
##        #
### @$   .#
###########
