#######
#@ $. #
#  $ .#
#  $. #
#######