#######
##. $ #
#.$ $ #
##$  @#
#.  . #
#######
