###########
# #       #
#  .. $   #
# $$   .  #
#        ##
#      $ .#
# $   . $ #
#    # .$ #
##.     @ #
###########
