##############
#   @      # #
# $. $.$$   .#
#  #    $   .#
##### $ $    #
####  ..   $ #
####     ..  #
##############
