###########
#        .#
#.    $ $ #
#  $@     #
#$        #
#         #
#. $.    .#
#.$   $   #
#   .     #
###########
