######
# .  #
#.$. #
# $  #
#@  .#
# $$ #
#    #
######
