############
#####   #..#
### .      #
###     $$$#
##. $ .  $@#
############
