######
##  @#
#.$$$#
#   .#
#. $ #
#   .#
######
