#########
#@  $ . #
#   #$# #
# $ # . #
# .   $ #
#########