#########
#   @   #
# $  $. #
#.$     #
# .  .  #
# $     #
#  $.   #
#$      #
#.#     #
#########
