#######
#   @ #
#  $$ #
#.$   #
#. $. #
##.   #
##. $ #
#######
