###############
#### #.    .  #
###     $ $ $ #
##.   @       #
##.  $        #
# $.$      .  #
# $   $  $  .##
#      $  ..###
#          .###
###############
