###########
#. $ .  @##
#$.  $.  .#
#         #
#         #
#  $  $.$ #
#        $#
#       . #
###########
