###############
#@.       .   #
#    .  $   $.#
# $ $       # #
#     $..     #
#      $  $.###
#   $      .###
###############
