########
###.  .#
#      #
#. $   #
#  $   #
# .@   #
#$$ $. #
#      #
########
