######
# @  #
#$$ .#
#   .#
# $ $#
#..  #
######
