 ###########
 #         #
 #  $ ####$#
## ####....#
#  $  #....#
#  $$ #..  #
## @$ ###  #
 # $$  $ $ #
 #      #  #
 ###########