######
# .  #
# #$##
# @$ #
# .  #
######