###########
# .. @    #
#   $ $   #
##    $ $ #
## #  $.. #
#  $  .   #
#   .     #
###########
