############
#    ####.##
#  $     $ #
#   .$. .  #
#      .$$@#
#     .  $ #
############
