#########
#       #
# $   $ #
# @.$  .#
# .$ .###
#########
