########
#  @   #
# $$$  #
# .# . #
#   .  #
# $..$ #
########
