##########
#   .    #
# $    $ #
#       .#
#  $  . ##
#  $ .@ ##
#. $  $ ##
#    .####
##########
