########
# .$.  #
# #### #
# #  @ #
# #    #
########