########
#@.$.  #
# $ #  #
# $ .  #
#   .  #
########