#######
# . @.#
#$   $#
#  .  #
# $  ##
# $ .##
#. $ ##
#    ##
#######
