############
##.       .#
# $  @  $$ #
#   $.     #
#   .$ .   #
############
