########
#@ $   #
#  ###.#
# $$ #.#
# .. # #
########