#######
#    @#
#$$ . #
#.# $ #
##..$ #
#######
