########
#      #
#   $  #
#     @#
#   .$ #
#   .  #
# $.   #
#.$  $ #
# $  ..#
########
