#######
#@ #  #
# $#. #
# $ . #
#  #  #
#######