#######
#@$ . #
# $ # #
# # $.#
# . $ #
#######