  #####
  #@  #
###$###
#  $. #
#.$ #
#   #
#####