############
#.   $..   #
##$  #.    #
##.# $   $ #
###    $ $ #
###@.      #
############
