###############
#             #
#    $.    $$ #
#      .$ . . #
#  .$ .     $@#
###############
