#######
#.    #
#.$ $ #
#   $ #
#    @#
#     #
#.$ $ #
#.  . #
#######
