#########
#     . #
# $ $   #
# ..$$  #
#  . . ##
# #     #
#   @$  #
#   $   #
#   .   #
#########
