#######
# . # . #
# $ @ $ #
#   #   #
#######