##########
#        #
# $ $    #
#   @    #
#$    .$ #
# $      #
#.. .. $ #
###   .  #
##########
