######
#@   #
# $$ #
#  . #
#  . #
######