######
#.   #
#  .$#
#$$#.#
#@$.##
######
