######
#    #
#@$ $#
#.$  #
# $. #
# .#.#
######
