#######
# .$. #
# #@# #
# $ $ #
# . . #
#######