###############
#             #
#   ..     $  #
# .   .       #
#  $$ $$  . $ #
#        .$ .@#
###############
