#########
#       #
#  $$ . #
#  @  . #
#  $$ $ #
#   .   #
#  ..   #
#########
