#############
#     $  .. #
#$  . $   $ #
#      .    #
# #  $ $    #
#  ..$  @   #
#.#         #
#############
