##########
#        #
#.$      #
#   @  $ #
#        #
# $.   $ #
# $ ...  #
#  .  $  #
# $     .#
##########
