#######
#@$..##
#$$  ##
#.$  ##
#     #
#     #
# . $ #
#  .  #
####  #
#######
