########
#  .   #
#  $####
##@$ . #
#   $  #
#   .  #
########