########
#@  $ .#
#      #
#  $ . #
#      #
########