############
# .        #
#.$$  $  . #
#      $ $ #
#.  .$.    #
###       @#
############
