#########
#       #
#. .    #
#    . ##
#$ $ $  #
# .   $ #
#.$ $.  #
#      @#
#########
