- + + + + + + + -
+ + - - + - - + +
+ - @ - % - @ - +
+ - - X * X - - +
+ + @ + + - - + +
+ - - X - - - + -
+ + + + + + + + -