###############
#.$           #
#. $    $     #
#      .#     #
#        .    #
#. $         .#
#.$ $   . $ $ #
#@$  .#       #
###############
