#########
#   #   #
# $ # . #
# @ # . #
# $ ### #
#   #   #
#########