  #####
  #@$.#
###$$.###
# .. $ .#
### . ###
  #####