########
#   . .#
# .@.$ #
# $ .$ #
#   $#$#
#      #
########
