#######
# . . #
# $$$ #
# @   #
#  .  #
#######