########
#      #
#.  $ .#
#  $   #
#$.$ $@#
# ..   #
########
