########
#@ $ . #
#  ### #
#  $ . #
########