##############
#.      $   .#
#$. $     .  #
# . $  .  $$ #
#          @ #
##############
