 ########
 # @#   #
 # $  $ #
 #$ #######
## $#     #
#. . .    #
#.  #######
#####