#############
#        .  #
# $  . $  .@#
#      $ $  #
#    .$     #
#    .   $.##
#############
