#####
#@  #
# $$#
# . #
# . #
#####