##########
#     @  #
#.$  .$ $#
#.$      #
# $  .##.#
##########
