#############
#  ##  $  . #
#  .       @#
#  $      $.#
#  $   .    #
#     .     #
#        $ .#
#    $ $  . #
###.      $ #
#############
