########
#@ $ . #
#  $ . #
#  $ . #
########