######
#@$. #
#$$  #
# .# #
# $  #
#.   #
##.###
######
