###############
### #  .   $  #
#.#.   $ $  $ #
#$$ .         #
#@#     . .   #
###############
