######
#    #
#.$@$#
#.$  #
#    #
######