#########
#       #
# $  $$.#
#   .   #
###. .. #
###   $$#
###    @#
#########
