##########
#.       #
#@$$. .$ #
#    .$  #
#  . $   #
##########
