########
#@  $ .#
#   #  #
# $ .  #
########