########
#   .  #
#  $$  #
#  @   #
# ###. #
#      #
########