##########
#        #
# .$$@.  #
#        #
##########