#######
#. $  #
#  .. #
# $   #
#     #
##  $.#
#  .  #
#  $$@#
#     #
#######
