#######
#     #
# .@$ #
#     #
#######