#######
#  @  #
# $$$ #
#.#.#.#
# . . #
#######