##############
#.     .#    #
#  $  .   $  #
#   @     .  #
# $ $     .$ #
#     $..$ $.#
#            #
##############
