########
#@ $   #
#  .$# #
# #$.  #
# . #  #
#   $ .#
########