#######
#  .  #
# $ @ #
## ##$#
 # .  #
 #    #
 ######