##########
#@ $  .  #
#  $##$. #
#  .##$  #
#    .   #
##########