#######
#@    #
# $## #
# $ . #
# .## #
#     #
#######