########
#.    .#
#      #
#  $ # #
#  $.# #
# $ .  #
#  .$$ #
#   @  #
########
