###########
# .   .  .#
# $$. $   #
#. $    $ #
###      @#
###########
