#########
#       #
#  .$@$ #
# .$    #
#    $  #
#..  .  #
# $ .$  #
#       #
#########
