############
#     ..   #
#.$ $    $ #
##       $@#
##.#    .$ #
#####    $ #
#####.$   .#
############
