##########
#        #
#. $$ .$ #
#$    .  #
#@$ . .###
##########
