########
#   .  #
# $#$ ##
# @ .  #
#   #  #
#######