#######
#@ $ .#
#  # ##
## $  #
# .   #
#######