######
# .  #
# $  #
# @###
# $  #
# .  #
######